11 20
|------------------|
|.F...|...P...|..F.|
|.-.-.|.-----.|.-.-|
|.P...|.F..F.|.....|
|.--..|......|.....|
|.....|..@...|.....|
|.--..|......|.....|
|.F...|.F..P.|.....|
|.-.-.|.-----.|.-.-|
|.P..F|...P...|..F.|
|------------------|